########################
#    @    #            #
#    %    #       %    #
#    $    #      %%%   #
# % # # % #       %    #
##### #####            #
#                    $ #
#                      #
########################