################################################################
#                                       $        $             #
# @                                                            #
#         %                                                    #
#                                                              #
#            %                                                 #
#                                                              #
#                                                              #
#                 %                                            #
#                                                              #
#                                                              #
#                                                              #
#                                                              #
#                $      $           $                          #
#                                                              #
################################################################