###############################################################
#    @    #            #                   #                  #
#    %    #       %    #                   #                  #
#    $    #      %%%   #                                      #
# % # # % #       %    #                   #                  #
##### #####            #                   #                  #
#                    $ #                   #                  #
#                      #                   #                  #
#################### ###                   #                  #
#                      #                   #                  #
#                      #                   #                  #
#                      ########### ###################### #####
#                                                             #
#                                                             #
#                                                             #
#                                                             #
#                                                             #
#                      % %                                    #
#                     %%%%%                                   #
#                      %%%                                    #
#                       %                                     #
#                                                             #
#                                                             #
#                                                             #
#                                                             #
#                                                             #
#                                                             #
#                                                             #
#                                                             #
#                                                             #
#                                                             #
#                                                             #
#                                                             #
#                                                             #
#                                                             #
###############################################################