###############################################################
#         #            #                   #                  #
#         #            #                   #                  #
#         #      % %   #                                      #
# % # # % #            #                                      #
##### #####            #                                      #
#                    $ #                   #                  #
#                      #                   #                  #
##################   ###                   #                  #
#                      #                   #                  #
#                      #                   #                  #
#                      #########   ####################   #####
#                                                             #
#                                                             >
<@                                                            #
#                                                             #
#                                                             #
#                      % %                                    #
#                     %%%%%                                   #
#                      %%%                                    #
#                       %                                     #
#                                                             #
#                                                             #
#                                                             #
#                                                             #
#                                                             #
#                                                             #
#                                                             #
#                                                             #
#                                                             #
#                                                             #
#                                                             #
#                                                             #
#                                                             #
#                                                             #
###############################################################