#################################
<@                              #
#                               #
#                               #
#                               #
#                               #
#                               #
#                               #
#                               #
#                               #
#                               #
#                               #
#                               #
#                               #
#                               >
#################################