#################################
<@ #          % %              ##
#   #        %   %            # #
#    #      %     %          #  #
#     #    %       %        #   #
#      #  %         %      #    #
#       E%           %    #     #
#       %E            %  #      #
#      %  #            %E       #
#     %    #           E%       #
#    %      #         #  %      #
#   %        #       #    %     #
#  %          #     #      %    #
# %            #   #        %   #
#%              # #          %  >
#################################
